5 10
|--------|
|PF.|..-.|
|..-|.@P.|
|.F....-.|
|--------|